{
    "map": {
        "tiles": [
                [1,1,1,1,1,1,1,1,1,1,1,1,1,1,1,1,1,1,1,1,1,1,1,1,1,1,1,1,1,1,1],
                [1,1,1,1,1,1,1,1,1,1,1,1,1,1,1,1,1,1,1,1,1,1,1,1,1,1,1,1,1,1,1],
                [1,1,1,1,1,1,1,1,1,1,1,1,1,1,1,1,1,1,1,1,1,1,1,1,1,1,1,1,1,1,1],
                [1,1,1,1,1,1,1,1,1,1,1,1,1,1,1,1,1,1,1,1,1,1,1,1,1,1,1,1,1,1,1],
                [1,1,1,1,1,1,1,1,1,1,1,1,1,1,1,1,1,1,1,1,1,1,1,1,1,1,1,1,1,1,1],
                [1,1,1,1,1,1,1,1,1,2,2,2,2,2,2,2,2,2,2,2,2,2,2,1,1,1,1,1,1,1,1],
                [1,1,1,1,1,1,1,1,1,1,1,2,2,3,3,3,2,2,2,2,2,2,2,1,1,1,1,1,1,1,1],
                [1,1,1,1,1,1,1,1,1,1,1,2,2,3,"c",3,2,2,2,2,2,2,2,1,1,1,1,1,1,1,1],
                [1,1,1,1,1,1,1,1,1,1,1,2,2,3,3,3,2,2,2,2,2,2,2,1,1,1,1,1,1,1,1],
                [1,1,1,1,1,1,1,1,1,1,1,2,2,2,2,2,2,2,2,2,2,2,2,1,1,1,1,1,1,1,1],
                [1,1,1,1,1,1,1,1,1,2,2,2,2,2,2,2,2,2,2,2,2,2,2,1,1,1,1,1,1,1,1],
                [1,1,1,1,1,1,1,1,1,1,1,1,1,1,1,1,1,1,1,1,1,1,1,1,1,1,1,1,1,1,1],
                [1,1,1,1,1,1,1,1,1,1,1,1,1,1,1,1,1,1,1,1,1,1,1,1,1,1,1,1,1,1,1],
                [1,1,1,1,1,1,1,1,1,1,1,1,1,1,1,1,1,1,1,1,1,1,1,1,1,1,1,1,1,1,1],
                [1,1,1,1,1,1,1,1,1,1,1,1,1,1,1,1,1,1,1,1,1,1,1,1,1,1,1,1,1,1,1],
                [1,1,1,1,1,1,1,1,1,1,1,1,1,1,1,1,1,1,1,1,1,1,1,1,1,1,1,1,1,1,1],
                [1,1,1,1,1,1,1,1,1,1,1,1,1,1,1,1,1,1,1,1,1,1,1,1,1,1,1,1,1,1,1]
        ],
        "locations": [
            { "name": "The void" },
            {
                "name": "Grasslands",
                "type": 1
            },
            {
                "name": "Water",
                "type": 2
            },
            {
                "name": "Little Green Island",
                "type": 1
            }
        ],
        "types": [
            { "name": "Unknown" },
            {
                "label": "Grassland",
                "id": "g",
                "movement": 2
            },
            {
                "label": "Water",
                "id": "w",
                "movement": 0
            }
        ]
    }
}